EEEEEEEEEEEEEEEEE1EEEEEEEE
EEEEGEEEEEEEEEEEE1EEEEEEEE
BBBBBBLBBBBBBBEEE1EEEEEEEE
EEEEEEL33333333331EEEEGEEE
EEEEEELEEEEBBLEEEBBBBBBLBB
EEEEEELEEEEBBLEEEEEEEEELEE
EEEEE4LEEEEBBLEEEEEEEG4LEE
BBLBBBBEEEEBBBBBBBBLBBBBBB
EELEEEEEEEEEEEEEEEELEEEEEE
EELEEEEEEEEEE4EEEEELEEEEEE
BBBBBBBBLBBBBBBBBBBLEEEEEE
EEEEEEEELEEEEEEEEEELEEEEEE
EEEEEEGEL3333333333LEEGEEE
EEEELBBBBBEEEEEEEEEBBBBBBL
EEEELEEEEEEEEPEEGEEEEEEEEL
BBBBBBBBBBBBBBBBBBBBBBBBBB
