EEEGEEEEEEEEEEEEEEEEEEEEEL
LCCBCCLEEEEEEEEEEGEEEEEEEL
LEEEEELEEEELBBBBBBBBLEGEEL
LEGE4ELEEEELEEEEEEEELBBB2L
LBCBCBLEEEELEEEEEEEELEEEE1
LEEEEEL3333L33333EE4LEEEE1
LEEEEELEEEELEEEELBBBCCCCCL
LEEEEELEEEELEGEELEEEEEEEEL
LEEE4ELEGEELBBBBLEEEEEEEEL
CBBBCBBCBBCLEEEEEEEELBBLBB
CBBBCEEEEEELEEEEEEEELEELEE
CGEECEEEEEELEE333333LEELEG
BBBBBBBBLBBBCCCEEEEELEBBBB
EEEEEEEELEEEEEEEEEEELEEEEE
EEEEEEEELEEEPEEEEEEELEEEEE
BBBBBBBBBBBBBBBBBBBBBBBBBB
